,county,sub-county,Age,Male,Female,Total
31604,NAIROBI,ALL,Total,2192452,2204376,4396828
31605,NAIROBI,ALL,0,57265,56523,113788
31606,NAIROBI,ALL,1,56019,54601,110620
31607,NAIROBI,ALL,2,52518,51848,104366
31608,NAIROBI,ALL,3,51115,51027,102142
31609,NAIROBI,ALL,4,47182,46889,94071
31610,NAIROBI,ALL,0 - 4,264099,260888,524987
31611,NAIROBI,ALL,5,45203,44711,89914
31612,NAIROBI,ALL,6,43635,44226,87861
31613,NAIROBI,ALL,7,43507,43655,87162
31614,NAIROBI,ALL,8,40916,41615,82531
31615,NAIROBI,ALL,9,41969,43275,85244
31616,NAIROBI,ALL,5-9,215230,217482,432712
31617,NAIROBI,ALL,10,40791,40892,81683
31618,NAIROBI,ALL,11,35581,37513,73094
31619,NAIROBI,ALL,12,37907,39622,77529
31620,NAIROBI,ALL,13,36701,39479,76180
31621,NAIROBI,ALL,14,34028,36036,70064
31622,NAIROBI,ALL,10 -14,185008,193542,378550
31623,NAIROBI,ALL,15,30919,35136,66055
31624,NAIROBI,ALL,16,30408,35599,66007
31625,NAIROBI,ALL,17,32413,37865,70278
31626,NAIROBI,ALL,18,29102,36415,65517
31627,NAIROBI,ALL,19,36256,47740,83996
31628,NAIROBI,ALL,15-19,159098,192755,351853
31629,NAIROBI,ALL,20,39853,55625,95478
31630,NAIROBI,ALL,21,45052,57938,102990
31631,NAIROBI,ALL,22,49186,62338,111524
31632,NAIROBI,ALL,23,57179,70152,127331
31633,NAIROBI,ALL,24,58264,67432,125696
31634,NAIROBI,ALL,20-24,249534,313485,563019
31635,NAIROBI,ALL,25,63693,69680,133373
31636,NAIROBI,ALL,26,56174,62288,118462
31637,NAIROBI,ALL,27,57764,60383,118147
31638,NAIROBI,ALL,28,50792,53563,104355
31639,NAIROBI,ALL,29,54280,54931,109211
31640,NAIROBI,ALL,25-29,282703,300845,583548
31641,NAIROBI,ALL,30,64070,65757,129827
31642,NAIROBI,ALL,31,44601,42537,87138
31643,NAIROBI,ALL,32,56015,54958,110973
31644,NAIROBI,ALL,33,43556,42761,86317
31645,NAIROBI,ALL,34,41234,39981,81215
31646,NAIROBI,ALL,30-34,249476,245994,495470
31647,NAIROBI,ALL,35,49053,44052,93105
31648,NAIROBI,ALL,36,35610,33131,68741
31649,NAIROBI,ALL,37,34835,30671,65506
31650,NAIROBI,ALL,38,30710,28604,59314
31651,NAIROBI,ALL,39,31593,27537,59130
31652,NAIROBI,ALL,35-39,181801,163995,345796
31653,NAIROBI,ALL,40,37229,30970,68199
31654,NAIROBI,ALL,41,29619,23693,53312
31655,NAIROBI,ALL,42,28657,22977,51634
31656,NAIROBI,ALL,43,24278,19898,44176
31657,NAIROBI,ALL,44,19495,16346,35841
31658,NAIROBI,ALL,40-44,139278,113884,253162
31659,NAIROBI,ALL,45,28137,21111,49248
31660,NAIROBI,ALL,46,19749,14969,34718
31661,NAIROBI,ALL,47,20398,14741,35139
31662,NAIROBI,ALL,48,15447,11472,26919
31663,NAIROBI,ALL,49,16988,11920,28908
31664,NAIROBI,ALL,45-49,100719,74213,174932
31665,NAIROBI,ALL,50,18699,14032,32731
31666,NAIROBI,ALL,51,12961,9112,22073
31667,NAIROBI,ALL,52,13381,9179,22560
31668,NAIROBI,ALL,53,9905,7611,17516
31669,NAIROBI,ALL,54,11271,7798,19069
31670,NAIROBI,ALL,50-54,66217,47732,113949
31671,NAIROBI,ALL,55,10869,7263,18132
31672,NAIROBI,ALL,56,10179,7370,17549
31673,NAIROBI,ALL,57,8966,6677,15643
31674,NAIROBI,ALL,58,7164,5147,12311
31675,NAIROBI,ALL,59,7561,5405,12966
31676,NAIROBI,ALL,55-59,44739,31862,76601
31677,NAIROBI,ALL,60,7694,6148,13842
31678,NAIROBI,ALL,61,5197,3948,9145
31679,NAIROBI,ALL,62,4853,3447,8300
31680,NAIROBI,ALL,63,4051,3103,7154
31681,NAIROBI,ALL,64,3106,2437,5543
31682,NAIROBI,ALL,60-64,24901,19083,43984
31683,NAIROBI,ALL,65,3992,3256,7248
31684,NAIROBI,ALL,66,2591,2191,4782
31685,NAIROBI,ALL,67,3553,2762,6315
31686,NAIROBI,ALL,68,1914,1612,3526
31687,NAIROBI,ALL,69,2408,2104,4512
31688,NAIROBI,ALL,65-69,14458,11925,26383
31689,NAIROBI,ALL,70,2676,2653,5329
31690,NAIROBI,ALL,71,1797,1541,3338
31691,NAIROBI,ALL,72,1672,1376,3048
31692,NAIROBI,ALL,73,1295,1119,2414
31693,NAIROBI,ALL,74,1129,1096,2225
31694,NAIROBI,ALL,70-74,8569,7785,16354
31695,NAIROBI,ALL,75,909,1084,1993
31696,NAIROBI,ALL,76,849,947,1796
31697,NAIROBI,ALL,77,682,763,1445
31698,NAIROBI,ALL,78,505,516,1021
31699,NAIROBI,ALL,79,530,652,1182
31700,NAIROBI,ALL,75-79,3475,3962,7437
31701,NAIROBI,ALL,80,603,917,1520
31702,NAIROBI,ALL,81,302,432,734
31703,NAIROBI,ALL,82,341,408,749
31704,NAIROBI,ALL,83,335,388,723
31705,NAIROBI,ALL,84,275,384,659
31706,NAIROBI,ALL,80-84,1856,2529,4385
31707,NAIROBI,ALL,85,243,335,578
31708,NAIROBI,ALL,86,172,268,440
31709,NAIROBI,ALL,87,155,270,425
31710,NAIROBI,ALL,88,111,132,243
31711,NAIROBI,ALL,89,116,248,364
31712,NAIROBI,ALL,85-89,797,1253,2050
31713,NAIROBI,ALL,90,89,218,307
31714,NAIROBI,ALL,91,65,135,200
31715,NAIROBI,ALL,92,47,98,145
31716,NAIROBI,ALL,93,39,75,114
31717,NAIROBI,ALL,94,30,77,107
31718,NAIROBI,ALL,90-94,270,603,873
31719,NAIROBI,ALL,95,32,108,140
31720,NAIROBI,ALL,96,29,65,94
31721,NAIROBI,ALL,97,22,46,68
31722,NAIROBI,ALL,98,16,34,50
31723,NAIROBI,ALL,99,16,66,82
31724,NAIROBI,ALL,95-99,115,319,434
31725,NAIROBI,ALL,100+,35,171,206
31726,NAIROBI,ALL,Not Stated,74,69,143
31727,NAIROBI,DAGORETTI,Total,217651,216526,434177
31728,NAIROBI,DAGORETTI,0,6004,5820,11824
31729,NAIROBI,DAGORETTI,1,5785,5715,11500
31730,NAIROBI,DAGORETTI,2,5241,5462,10703
31731,NAIROBI,DAGORETTI,3,5172,5285,10457
31732,NAIROBI,DAGORETTI,4,4814,4691,9505
31733,NAIROBI,DAGORETTI,0 - 4,27016,26973,53989
31734,NAIROBI,DAGORETTI,5,4395,4548,8943
31735,NAIROBI,DAGORETTI,6,4367,4531,8898
31736,NAIROBI,DAGORETTI,7,4465,4340,8805
31737,NAIROBI,DAGORETTI,8,4112,4220,8332
31738,NAIROBI,DAGORETTI,9,4186,4392,8578
31739,NAIROBI,DAGORETTI,5-9,21525,22031,43556
31740,NAIROBI,DAGORETTI,10,4070,4185,8255
31741,NAIROBI,DAGORETTI,11,3528,3671,7199
31742,NAIROBI,DAGORETTI,12,3791,4076,7867
31743,NAIROBI,DAGORETTI,13,3848,3984,7832
31744,NAIROBI,DAGORETTI,14,3410,3695,7105
31745,NAIROBI,DAGORETTI,10 -14,18647,19611,38258
31746,NAIROBI,DAGORETTI,15,3028,3461,6489
31747,NAIROBI,DAGORETTI,16,3024,3490,6514
31748,NAIROBI,DAGORETTI,17,3263,3711,6974
31749,NAIROBI,DAGORETTI,18,2857,3368,6225
31750,NAIROBI,DAGORETTI,19,3529,4371,7900
31751,NAIROBI,DAGORETTI,15-19,15701,18401,34102
31752,NAIROBI,DAGORETTI,20,3764,5189,8953
31753,NAIROBI,DAGORETTI,21,4323,5574,9897
31754,NAIROBI,DAGORETTI,22,4786,5822,10608
31755,NAIROBI,DAGORETTI,23,5487,6626,12113
31756,NAIROBI,DAGORETTI,24,5800,6511,12311
31757,NAIROBI,DAGORETTI,20-24,24160,29722,53882
31758,NAIROBI,DAGORETTI,25,6281,6717,12998
31759,NAIROBI,DAGORETTI,26,5814,6117,11931
31760,NAIROBI,DAGORETTI,27,5969,6067,12036
31761,NAIROBI,DAGORETTI,28,5298,5196,10494
31762,NAIROBI,DAGORETTI,29,5559,5425,10984
31763,NAIROBI,DAGORETTI,25-29,28921,29522,58443
31764,NAIROBI,DAGORETTI,30,6402,6357,12759
31765,NAIROBI,DAGORETTI,31,4555,4159,8714
31766,NAIROBI,DAGORETTI,32,5708,5365,11073
31767,NAIROBI,DAGORETTI,33,4322,4168,8490
31768,NAIROBI,DAGORETTI,34,4009,3833,7842
31769,NAIROBI,DAGORETTI,30-34,24996,23882,48878
31770,NAIROBI,DAGORETTI,35,4847,4267,9114
31771,NAIROBI,DAGORETTI,36,3588,3264,6852
31772,NAIROBI,DAGORETTI,37,3415,3021,6436
31773,NAIROBI,DAGORETTI,38,2918,2810,5728
31774,NAIROBI,DAGORETTI,39,3015,2666,5681
31775,NAIROBI,DAGORETTI,35-39,17783,16028,33811
31776,NAIROBI,DAGORETTI,40,3534,3056,6590
31777,NAIROBI,DAGORETTI,41,2908,2383,5291
31778,NAIROBI,DAGORETTI,42,2916,2333,5249
31779,NAIROBI,DAGORETTI,43,2377,2028,4405
31780,NAIROBI,DAGORETTI,44,1881,1549,3430
31781,NAIROBI,DAGORETTI,40-44,13616,11349,24965
31782,NAIROBI,DAGORETTI,45,2722,2138,4860
31783,NAIROBI,DAGORETTI,46,2002,1485,3487
31784,NAIROBI,DAGORETTI,47,2092,1460,3552
31785,NAIROBI,DAGORETTI,48,1490,1096,2586
31786,NAIROBI,DAGORETTI,49,1685,1146,2831
31787,NAIROBI,DAGORETTI,45-49,9991,7325,17316
31788,NAIROBI,DAGORETTI,50,1775,1291,3066
31789,NAIROBI,DAGORETTI,51,1297,901,2198
31790,NAIROBI,DAGORETTI,52,1281,881,2162
31791,NAIROBI,DAGORETTI,53,998,667,1665
31792,NAIROBI,DAGORETTI,54,999,750,1749
31793,NAIROBI,DAGORETTI,50-54,6350,4490,10840
31794,NAIROBI,DAGORETTI,55,1031,674,1705
31795,NAIROBI,DAGORETTI,56,944,640,1584
31796,NAIROBI,DAGORETTI,57,843,613,1456
31797,NAIROBI,DAGORETTI,58,606,461,1067
31798,NAIROBI,DAGORETTI,59,682,480,1162
31799,NAIROBI,DAGORETTI,55-59,4106,2868,6974
31800,NAIROBI,DAGORETTI,60,733,571,1304
31801,NAIROBI,DAGORETTI,61,468,335,803
31802,NAIROBI,DAGORETTI,62,461,312,773
31803,NAIROBI,DAGORETTI,63,383,266,649
31804,NAIROBI,DAGORETTI,64,258,193,451
31805,NAIROBI,DAGORETTI,60-64,2303,1677,3980
31806,NAIROBI,DAGORETTI,65,336,276,612
31807,NAIROBI,DAGORETTI,66,186,187,373
31808,NAIROBI,DAGORETTI,67,351,236,587
31809,NAIROBI,DAGORETTI,68,132,126,258
31810,NAIROBI,DAGORETTI,69,204,171,375
31811,NAIROBI,DAGORETTI,65-69,1209,996,2205
31812,NAIROBI,DAGORETTI,70,238,200,438
31813,NAIROBI,DAGORETTI,71,148,155,303
31814,NAIROBI,DAGORETTI,72,146,117,263
31815,NAIROBI,DAGORETTI,73,107,90,197
31816,NAIROBI,DAGORETTI,74,94,106,200
31817,NAIROBI,DAGORETTI,70-74,733,668,1401
31818,NAIROBI,DAGORETTI,75,62,97,159
31819,NAIROBI,DAGORETTI,76,84,114,198
31820,NAIROBI,DAGORETTI,77,58,86,144
31821,NAIROBI,DAGORETTI,78,45,55,100
31822,NAIROBI,DAGORETTI,79,56,72,128
31823,NAIROBI,DAGORETTI,75-79,305,424,729
31824,NAIROBI,DAGORETTI,80,52,97,149
31825,NAIROBI,DAGORETTI,81,23,49,72
31826,NAIROBI,DAGORETTI,82,27,35,62
31827,NAIROBI,DAGORETTI,83,31,42,73
31828,NAIROBI,DAGORETTI,84,27,38,65
31829,NAIROBI,DAGORETTI,80-84,160,261,421
31830,NAIROBI,DAGORETTI,85,24,44,68
31831,NAIROBI,DAGORETTI,86,17,37,54
31832,NAIROBI,DAGORETTI,87,15,27,42
31833,NAIROBI,DAGORETTI,88,9,12,21
31834,NAIROBI,DAGORETTI,89,9,26,35
31835,NAIROBI,DAGORETTI,85-89,74,146,220
31836,NAIROBI,DAGORETTI,90,13,27,40
31837,NAIROBI,DAGORETTI,91,7,14,21
31838,NAIROBI,DAGORETTI,92,2,13,15
31839,NAIROBI,DAGORETTI,93,4,9,13
31840,NAIROBI,DAGORETTI,94,5,14,19
31841,NAIROBI,DAGORETTI,90-94,31,77,108
31842,NAIROBI,DAGORETTI,95,6,19,25
31843,NAIROBI,DAGORETTI,96,1,10,11
31844,NAIROBI,DAGORETTI,97,1,8,9
31845,NAIROBI,DAGORETTI,98,2,3,5
31846,NAIROBI,DAGORETTI,99,1,4,5
31847,NAIROBI,DAGORETTI,95-99,11,44,55
31848,NAIROBI,DAGORETTI,100+,2,24,26
31849,NAIROBI,DAGORETTI,Not Stated,11,7,18
31850,NAIROBI,EMBAKASI,Total,492476,496270,988746
31851,NAIROBI,EMBAKASI,0,13913,13982,27895
31852,NAIROBI,EMBAKASI,1,13420,13073,26493
31853,NAIROBI,EMBAKASI,2,12537,12367,24904
31854,NAIROBI,EMBAKASI,3,12206,12172,24378
31855,NAIROBI,EMBAKASI,4,11112,11176,22288
31856,NAIROBI,EMBAKASI,0 - 4,63188,62770,125958
31857,NAIROBI,EMBAKASI,5,10638,10405,21043
31858,NAIROBI,EMBAKASI,6,10083,10174,20257
31859,NAIROBI,EMBAKASI,7,9841,9890,19731
31860,NAIROBI,EMBAKASI,8,9246,9295,18541
31861,NAIROBI,EMBAKASI,9,9305,9657,18962
31862,NAIROBI,EMBAKASI,5-9,49113,49421,98534
31863,NAIROBI,EMBAKASI,10,8910,8981,17891
31864,NAIROBI,EMBAKASI,11,7704,8195,15899
31865,NAIROBI,EMBAKASI,12,8037,8494,16531
31866,NAIROBI,EMBAKASI,13,7570,8222,15792
31867,NAIROBI,EMBAKASI,14,6850,7477,14327
31868,NAIROBI,EMBAKASI,10 -14,39071,41369,80440
31869,NAIROBI,EMBAKASI,15,6120,7280,13400
31870,NAIROBI,EMBAKASI,16,5990,7300,13290
31871,NAIROBI,EMBAKASI,17,6150,7956,14106
31872,NAIROBI,EMBAKASI,18,5634,7839,13473
31873,NAIROBI,EMBAKASI,19,7073,10781,17854
31874,NAIROBI,EMBAKASI,15-19,30967,41156,72123
31875,NAIROBI,EMBAKASI,20,7990,12731,20721
31876,NAIROBI,EMBAKASI,21,9271,13386,22657
31877,NAIROBI,EMBAKASI,22,10153,14570,24723
31878,NAIROBI,EMBAKASI,23,12570,17129,29699
31879,NAIROBI,EMBAKASI,24,13336,16815,30151
31880,NAIROBI,EMBAKASI,20-24,53320,74631,127951
31881,NAIROBI,EMBAKASI,25,15569,17820,33389
31882,NAIROBI,EMBAKASI,26,14107,15890,29997
31883,NAIROBI,EMBAKASI,27,14536,15293,29829
31884,NAIROBI,EMBAKASI,28,12787,13686,26473
31885,NAIROBI,EMBAKASI,29,14254,14202,28456
31886,NAIROBI,EMBAKASI,25-29,71253,76891,148144
31887,NAIROBI,EMBAKASI,30,16747,16733,33480
31888,NAIROBI,EMBAKASI,31,11696,10539,22235
31889,NAIROBI,EMBAKASI,32,14601,13359,27960
31890,NAIROBI,EMBAKASI,33,11258,10233,21491
31891,NAIROBI,EMBAKASI,34,10524,9316,19840
31892,NAIROBI,EMBAKASI,30-34,64826,60180,125006
31893,NAIROBI,EMBAKASI,35,12339,9964,22303
31894,NAIROBI,EMBAKASI,36,8738,7599,16337
31895,NAIROBI,EMBAKASI,37,8459,6785,15244
31896,NAIROBI,EMBAKASI,38,7508,6386,13894
31897,NAIROBI,EMBAKASI,39,7684,6103,13787
31898,NAIROBI,EMBAKASI,35-39,44728,36837,81565
31899,NAIROBI,EMBAKASI,40,8537,6398,14935
31900,NAIROBI,EMBAKASI,41,6853,4782,11635
31901,NAIROBI,EMBAKASI,42,6402,4581,10983
31902,NAIROBI,EMBAKASI,43,5460,3811,9271
31903,NAIROBI,EMBAKASI,44,4259,3058,7317
31904,NAIROBI,EMBAKASI,40-44,31511,22630,54141
31905,NAIROBI,EMBAKASI,45,6003,3805,9808
31906,NAIROBI,EMBAKASI,46,4003,2577,6580
31907,NAIROBI,EMBAKASI,47,4020,2550,6570
31908,NAIROBI,EMBAKASI,48,2966,1890,4856
31909,NAIROBI,EMBAKASI,49,3268,2020,5288
31910,NAIROBI,EMBAKASI,45-49,20260,12842,33102
31911,NAIROBI,EMBAKASI,50,3393,2237,5630
31912,NAIROBI,EMBAKASI,51,2313,1461,3774
31913,NAIROBI,EMBAKASI,52,2193,1370,3563
31914,NAIROBI,EMBAKASI,53,1617,1358,2975
31915,NAIROBI,EMBAKASI,54,1871,1093,2964
31916,NAIROBI,EMBAKASI,50-54,11387,7519,18906
31917,NAIROBI,EMBAKASI,55,1675,1029,2704
31918,NAIROBI,EMBAKASI,56,1493,1069,2562
31919,NAIROBI,EMBAKASI,57,1273,952,2225
31920,NAIROBI,EMBAKASI,58,976,734,1710
31921,NAIROBI,EMBAKASI,59,1112,782,1894
31922,NAIROBI,EMBAKASI,55-59,6529,4566,11095
31923,NAIROBI,EMBAKASI,60,1037,830,1867
31924,NAIROBI,EMBAKASI,61,739,520,1259
31925,NAIROBI,EMBAKASI,62,668,430,1098
31926,NAIROBI,EMBAKASI,63,507,356,863
31927,NAIROBI,EMBAKASI,64,428,284,712
31928,NAIROBI,EMBAKASI,60-64,3379,2420,5799
31929,NAIROBI,EMBAKASI,65,434,398,832
31930,NAIROBI,EMBAKASI,66,298,267,565
31931,NAIROBI,EMBAKASI,67,370,351,721
31932,NAIROBI,EMBAKASI,68,199,176,375
31933,NAIROBI,EMBAKASI,69,279,227,506
31934,NAIROBI,EMBAKASI,65-69,1580,1419,2999
31935,NAIROBI,EMBAKASI,70,293,317,610
31936,NAIROBI,EMBAKASI,71,192,170,362
31937,NAIROBI,EMBAKASI,72,157,135,292
31938,NAIROBI,EMBAKASI,73,128,96,224
31939,NAIROBI,EMBAKASI,74,97,88,185
31940,NAIROBI,EMBAKASI,70-74,867,806,1673
31941,NAIROBI,EMBAKASI,75,87,108,195
31942,NAIROBI,EMBAKASI,76,53,72,125
31943,NAIROBI,EMBAKASI,77,45,58,103
31944,NAIROBI,EMBAKASI,78,31,64,95
31945,NAIROBI,EMBAKASI,79,51,51,102
31946,NAIROBI,EMBAKASI,75-79,267,353,620
31947,NAIROBI,EMBAKASI,80,54,89,143
31948,NAIROBI,EMBAKASI,81,19,30,49
31949,NAIROBI,EMBAKASI,82,20,29,49
31950,NAIROBI,EMBAKASI,83,22,30,52
31951,NAIROBI,EMBAKASI,84,19,42,61
31952,NAIROBI,EMBAKASI,80-84,134,220,354
31953,NAIROBI,EMBAKASI,85,16,28,44
31954,NAIROBI,EMBAKASI,86,8,19,27
31955,NAIROBI,EMBAKASI,87,15,32,47
31956,NAIROBI,EMBAKASI,88,7,7,14
31957,NAIROBI,EMBAKASI,89,9,19,28
31958,NAIROBI,EMBAKASI,85-89,55,105,160
31959,NAIROBI,EMBAKASI,90,6,30,36
31960,NAIROBI,EMBAKASI,91,1,17,18
31961,NAIROBI,EMBAKASI,92,4,6,10
31962,NAIROBI,EMBAKASI,93,2,4,6
31963,NAIROBI,EMBAKASI,94,2,8,10
31964,NAIROBI,EMBAKASI,90-94,15,65,80
31965,NAIROBI,EMBAKASI,95,2,18,20
31966,NAIROBI,EMBAKASI,96,2,4,6
31967,NAIROBI,EMBAKASI,97,2,3,5
31968,NAIROBI,EMBAKASI,98,1,2,3
31969,NAIROBI,EMBAKASI,99,1,9,10
31970,NAIROBI,EMBAKASI,95-99,8,36,44
31971,NAIROBI,EMBAKASI,100+,4,22,26
31972,NAIROBI,EMBAKASI,Not Stated,14,12,26
31973,NAIROBI,KAMUKUNJI,Total,136670,131599,268269
31974,NAIROBI,KAMUKUNJI,0,3769,3723,7492
31975,NAIROBI,KAMUKUNJI,1,3560,3428,6988
31976,NAIROBI,KAMUKUNJI,2,3454,3260,6714
31977,NAIROBI,KAMUKUNJI,3,3397,3191,6588
31978,NAIROBI,KAMUKUNJI,4,3133,3072,6205
31979,NAIROBI,KAMUKUNJI,0 - 4,17313,16674,33987
31980,NAIROBI,KAMUKUNJI,5,3145,2926,6071
31981,NAIROBI,KAMUKUNJI,6,2802,2818,5620
31982,NAIROBI,KAMUKUNJI,7,2802,2831,5633
31983,NAIROBI,KAMUKUNJI,8,2590,2583,5173
31984,NAIROBI,KAMUKUNJI,9,2647,2642,5289
31985,NAIROBI,KAMUKUNJI,5-9,13986,13800,27786
31986,NAIROBI,KAMUKUNJI,10,2604,2576,5180
31987,NAIROBI,KAMUKUNJI,11,2243,2336,4579
31988,NAIROBI,KAMUKUNJI,12,2347,2413,4760
31989,NAIROBI,KAMUKUNJI,13,2338,2524,4862
31990,NAIROBI,KAMUKUNJI,14,2328,2340,4668
31991,NAIROBI,KAMUKUNJI,10 -14,11860,12189,24049
31992,NAIROBI,KAMUKUNJI,15,2118,2391,4509
31993,NAIROBI,KAMUKUNJI,16,2208,2573,4781
31994,NAIROBI,KAMUKUNJI,17,2419,2673,5092
31995,NAIROBI,KAMUKUNJI,18,2216,2515,4731
31996,NAIROBI,KAMUKUNJI,19,2643,3163,5806
31997,NAIROBI,KAMUKUNJI,15-19,11604,13315,24919
31998,NAIROBI,KAMUKUNJI,20,3109,3791,6900
31999,NAIROBI,KAMUKUNJI,21,3410,3615,7025
32000,NAIROBI,KAMUKUNJI,22,3699,4005,7704
32001,NAIROBI,KAMUKUNJI,23,4019,4142,8161
32002,NAIROBI,KAMUKUNJI,24,3922,3906,7828
32003,NAIROBI,KAMUKUNJI,20-24,18159,19459,37618
32004,NAIROBI,KAMUKUNJI,25,4345,4145,8490
32005,NAIROBI,KAMUKUNJI,26,3572,3544,7116
32006,NAIROBI,KAMUKUNJI,27,3541,3361,6902
32007,NAIROBI,KAMUKUNJI,28,3087,2938,6025
32008,NAIROBI,KAMUKUNJI,29,2965,2836,5801
32009,NAIROBI,KAMUKUNJI,25-29,17510,16824,34334
32010,NAIROBI,KAMUKUNJI,30,3654,3663,7317
32011,NAIROBI,KAMUKUNJI,31,2486,2246,4732
32012,NAIROBI,KAMUKUNJI,32,3036,2909,5945
32013,NAIROBI,KAMUKUNJI,33,2374,2258,4632
32014,NAIROBI,KAMUKUNJI,34,2184,2063,4247
32015,NAIROBI,KAMUKUNJI,30-34,13734,13139,26873
32016,NAIROBI,KAMUKUNJI,35,2840,2417,5257
32017,NAIROBI,KAMUKUNJI,36,1918,1684,3602
32018,NAIROBI,KAMUKUNJI,37,1832,1643,3475
32019,NAIROBI,KAMUKUNJI,38,1624,1369,2993
32020,NAIROBI,KAMUKUNJI,39,1726,1357,3083
32021,NAIROBI,KAMUKUNJI,35-39,9940,8470,18410
32022,NAIROBI,KAMUKUNJI,40,2241,1733,3974
32023,NAIROBI,KAMUKUNJI,41,1614,1207,2821
32024,NAIROBI,KAMUKUNJI,42,1560,1165,2725
32025,NAIROBI,KAMUKUNJI,43,1323,1016,2339
32026,NAIROBI,KAMUKUNJI,44,1002,822,1824
32027,NAIROBI,KAMUKUNJI,40-44,7740,5943,13683
32028,NAIROBI,KAMUKUNJI,45,1634,1265,2899
32029,NAIROBI,KAMUKUNJI,46,1082,764,1846
32030,NAIROBI,KAMUKUNJI,47,1048,763,1811
32031,NAIROBI,KAMUKUNJI,48,797,596,1393
32032,NAIROBI,KAMUKUNJI,49,904,689,1593
32033,NAIROBI,KAMUKUNJI,45-49,5465,4077,9542
32034,NAIROBI,KAMUKUNJI,50,1054,826,1880
32035,NAIROBI,KAMUKUNJI,51,680,478,1158
32036,NAIROBI,KAMUKUNJI,52,722,486,1208
32037,NAIROBI,KAMUKUNJI,53,527,421,948
32038,NAIROBI,KAMUKUNJI,54,605,423,1028
32039,NAIROBI,KAMUKUNJI,50-54,3588,2634,6222
32040,NAIROBI,KAMUKUNJI,55,623,457,1080
32041,NAIROBI,KAMUKUNJI,56,516,411,927
32042,NAIROBI,KAMUKUNJI,57,510,379,889
32043,NAIROBI,KAMUKUNJI,58,378,265,643
32044,NAIROBI,KAMUKUNJI,59,401,338,739
32045,NAIROBI,KAMUKUNJI,55-59,2428,1850,4278
32046,NAIROBI,KAMUKUNJI,60,476,503,979
32047,NAIROBI,KAMUKUNJI,61,273,239,512
32048,NAIROBI,KAMUKUNJI,62,267,218,485
32049,NAIROBI,KAMUKUNJI,63,241,187,428
32050,NAIROBI,KAMUKUNJI,64,165,161,326
32051,NAIROBI,KAMUKUNJI,60-64,1422,1308,2730
32052,NAIROBI,KAMUKUNJI,65,259,283,542
32053,NAIROBI,KAMUKUNJI,66,155,127,282
32054,NAIROBI,KAMUKUNJI,67,201,175,376
32055,NAIROBI,KAMUKUNJI,68,100,96,196
32056,NAIROBI,KAMUKUNJI,69,133,150,283
32057,NAIROBI,KAMUKUNJI,65-69,848,831,1679
32058,NAIROBI,KAMUKUNJI,70,234,252,486
32059,NAIROBI,KAMUKUNJI,71,120,106,226
32060,NAIROBI,KAMUKUNJI,72,127,94,221
32061,NAIROBI,KAMUKUNJI,73,102,63,165
32062,NAIROBI,KAMUKUNJI,74,88,68,156
32063,NAIROBI,KAMUKUNJI,70-74,671,583,1254
32064,NAIROBI,KAMUKUNJI,75,67,91,158
32065,NAIROBI,KAMUKUNJI,76,50,60,110
32066,NAIROBI,KAMUKUNJI,77,43,44,87
32067,NAIROBI,KAMUKUNJI,78,40,23,63
32068,NAIROBI,KAMUKUNJI,79,28,31,59
32069,NAIROBI,KAMUKUNJI,75-79,228,249,477
32070,NAIROBI,KAMUKUNJI,80,39,80,119
32071,NAIROBI,KAMUKUNJI,81,24,19,43
32072,NAIROBI,KAMUKUNJI,82,18,14,32
32073,NAIROBI,KAMUKUNJI,83,17,11,28
32074,NAIROBI,KAMUKUNJI,84,17,21,38
32075,NAIROBI,KAMUKUNJI,80-84,115,145,260
32076,NAIROBI,KAMUKUNJI,85,16,18,34
32077,NAIROBI,KAMUKUNJI,86,8,8,16
32078,NAIROBI,KAMUKUNJI,87,5,13,18
32079,NAIROBI,KAMUKUNJI,88,1,3,4
32080,NAIROBI,KAMUKUNJI,89,5,9,14
32081,NAIROBI,KAMUKUNJI,85-89,35,51,86
32082,NAIROBI,KAMUKUNJI,90,4,18,22
32083,NAIROBI,KAMUKUNJI,91,5,11,16
32084,NAIROBI,KAMUKUNJI,92,1,5,6
32085,NAIROBI,KAMUKUNJI,93,2,2,4
32086,NAIROBI,KAMUKUNJI,94,-,2,2
32087,NAIROBI,KAMUKUNJI,90-94,12,38,50
32088,NAIROBI,KAMUKUNJI,95,-,4,4
32089,NAIROBI,KAMUKUNJI,96,1,-,1
32090,NAIROBI,KAMUKUNJI,97,2,-,2
32091,NAIROBI,KAMUKUNJI,98,-,2,2
32092,NAIROBI,KAMUKUNJI,99,-,1,1
32093,NAIROBI,KAMUKUNJI,95-99,3,7,10
32094,NAIROBI,KAMUKUNJI,100+,1,9,10
32095,NAIROBI,KAMUKUNJI,Not Stated,8,4,12
32096,NAIROBI,KASARANI,Total,381234,399385,780619
32097,NAIROBI,KASARANI,0,10662,10899,21561
32098,NAIROBI,KASARANI,1,10525,10281,20806
32099,NAIROBI,KASARANI,2,9741,9825,19566
32100,NAIROBI,KASARANI,3,9252,9393,18645
32101,NAIROBI,KASARANI,4,8631,8463,17094
32102,NAIROBI,KASARANI,0 - 4,48811,48861,97672
32103,NAIROBI,KASARANI,5,8166,8085,16251
32104,NAIROBI,KASARANI,6,7940,7967,15907
32105,NAIROBI,KASARANI,7,7720,7957,15677
32106,NAIROBI,KASARANI,8,7296,7508,14804
32107,NAIROBI,KASARANI,9,7397,7595,14992
32108,NAIROBI,KASARANI,5-9,38519,39112,77631
32109,NAIROBI,KASARANI,10,7258,7176,14434
32110,NAIROBI,KASARANI,11,6234,6701,12935
32111,NAIROBI,KASARANI,12,6617,6988,13605
32112,NAIROBI,KASARANI,13,6519,7094,13613
32113,NAIROBI,KASARANI,14,6014,6352,12366
32114,NAIROBI,KASARANI,10 -14,32642,34311,66953
32115,NAIROBI,KASARANI,15,5429,6215,11644
32116,NAIROBI,KASARANI,16,5158,6194,11352
32117,NAIROBI,KASARANI,17,5547,6686,12233
32118,NAIROBI,KASARANI,18,4870,6478,11348
32119,NAIROBI,KASARANI,19,6269,8667,14936
32120,NAIROBI,KASARANI,15-19,27273,34240,61513
32121,NAIROBI,KASARANI,20,6517,10050,16567
32122,NAIROBI,KASARANI,21,7526,10640,18166
32123,NAIROBI,KASARANI,22,8486,11820,20306
32124,NAIROBI,KASARANI,23,10215,13444,23659
32125,NAIROBI,KASARANI,24,10358,13147,23505
32126,NAIROBI,KASARANI,20-24,43102,59101,102203
32127,NAIROBI,KASARANI,25,11221,13488,24709
32128,NAIROBI,KASARANI,26,10052,12207,22259
32129,NAIROBI,KASARANI,27,10716,11797,22513
32130,NAIROBI,KASARANI,28,9375,10611,19986
32131,NAIROBI,KASARANI,29,10137,10524,20661
32132,NAIROBI,KASARANI,25-29,51501,58627,110128
32133,NAIROBI,KASARANI,30,11814,12495,24309
32134,NAIROBI,KASARANI,31,8111,8079,16190
32135,NAIROBI,KASARANI,32,10036,10207,20243
32136,NAIROBI,KASARANI,33,7854,8082,15936
32137,NAIROBI,KASARANI,34,7425,7514,14939
32138,NAIROBI,KASARANI,30-34,45240,46377,91617
32139,NAIROBI,KASARANI,35,8575,7957,16532
32140,NAIROBI,KASARANI,36,6147,5943,12090
32141,NAIROBI,KASARANI,37,6040,5405,11445
32142,NAIROBI,KASARANI,38,5226,5114,10340
32143,NAIROBI,KASARANI,39,5360,4743,10103
32144,NAIROBI,KASARANI,35-39,31348,29162,60510
32145,NAIROBI,KASARANI,40,6333,5222,11555
32146,NAIROBI,KASARANI,41,4817,3960,8777
32147,NAIROBI,KASARANI,42,4632,3721,8353
32148,NAIROBI,KASARANI,43,3818,3296,7114
32149,NAIROBI,KASARANI,44,3023,2641,5664
32150,NAIROBI,KASARANI,40-44,22623,18840,41463
32151,NAIROBI,KASARANI,45,4271,3520,7791
32152,NAIROBI,KASARANI,46,3035,2375,5410
32153,NAIROBI,KASARANI,47,3251,2400,5651
32154,NAIROBI,KASARANI,48,2421,1841,4262
32155,NAIROBI,KASARANI,49,2585,1853,4438
32156,NAIROBI,KASARANI,45-49,15563,11989,27552
32157,NAIROBI,KASARANI,50,2874,2279,5153
32158,NAIROBI,KASARANI,51,1996,1428,3424
32159,NAIROBI,KASARANI,52,2177,1506,3683
32160,NAIROBI,KASARANI,53,1522,1134,2656
32161,NAIROBI,KASARANI,54,1744,1259,3003
32162,NAIROBI,KASARANI,50-54,10313,7606,17919
32163,NAIROBI,KASARANI,55,1747,1180,2927
32164,NAIROBI,KASARANI,56,1649,1154,2803
32165,NAIROBI,KASARANI,57,1331,1013,2344
32166,NAIROBI,KASARANI,58,1121,745,1866
32167,NAIROBI,KASARANI,59,1102,796,1898
32168,NAIROBI,KASARANI,55-59,6950,4888,11838
32169,NAIROBI,KASARANI,60,1204,863,2067
32170,NAIROBI,KASARANI,61,739,575,1314
32171,NAIROBI,KASARANI,62,666,482,1148
32172,NAIROBI,KASARANI,63,569,449,1018
32173,NAIROBI,KASARANI,64,423,308,731
32174,NAIROBI,KASARANI,60-64,3601,2677,6278
32175,NAIROBI,KASARANI,65,590,446,1036
32176,NAIROBI,KASARANI,66,362,276,638
32177,NAIROBI,KASARANI,67,507,389,896
32178,NAIROBI,KASARANI,68,244,189,433
32179,NAIROBI,KASARANI,69,303,268,571
32180,NAIROBI,KASARANI,65-69,2006,1568,3574
32181,NAIROBI,KASARANI,70,336,349,685
32182,NAIROBI,KASARANI,71,239,174,413
32183,NAIROBI,KASARANI,72,207,146,353
32184,NAIROBI,KASARANI,73,154,120,274
32185,NAIROBI,KASARANI,74,126,141,267
32186,NAIROBI,KASARANI,70-74,1062,930,1992
32187,NAIROBI,KASARANI,75,82,121,203
32188,NAIROBI,KASARANI,76,91,114,205
32189,NAIROBI,KASARANI,77,75,74,149
32190,NAIROBI,KASARANI,78,47,53,100
32191,NAIROBI,KASARANI,79,52,84,136
32192,NAIROBI,KASARANI,75-79,347,446,793
32193,NAIROBI,KASARANI,80,73,119,192
32194,NAIROBI,KASARANI,81,24,56,80
32195,NAIROBI,KASARANI,82,23,40,63
32196,NAIROBI,KASARANI,83,31,50,81
32197,NAIROBI,KASARANI,84,28,53,81
32198,NAIROBI,KASARANI,80-84,179,318,497
32199,NAIROBI,KASARANI,85,23,36,59
32200,NAIROBI,KASARANI,86,16,25,41
32201,NAIROBI,KASARANI,87,10,35,45
32202,NAIROBI,KASARANI,88,13,14,27
32203,NAIROBI,KASARANI,89,18,41,59
32204,NAIROBI,KASARANI,85-89,80,151,231
32205,NAIROBI,KASARANI,90,5,28,33
32206,NAIROBI,KASARANI,91,14,19,33
32207,NAIROBI,KASARANI,92,8,15,23
32208,NAIROBI,KASARANI,93,5,9,14
32209,NAIROBI,KASARANI,94,2,11,13
32210,NAIROBI,KASARANI,90-94,34,82,116
32211,NAIROBI,KASARANI,95,3,17,20
32212,NAIROBI,KASARANI,96,5,10,15
32213,NAIROBI,KASARANI,97,5,9,14
32214,NAIROBI,KASARANI,98,6,6,12
32215,NAIROBI,KASARANI,99,1,11,12
32216,NAIROBI,KASARANI,95-99,20,53,73
32217,NAIROBI,KASARANI,100+,10,30,40
32218,NAIROBI,KASARANI,Not Stated,10,16,26
32219,NAIROBI,KIBRA,Total,94199,91569,185768
32220,NAIROBI,KIBRA,0,2163,2134,4297
32221,NAIROBI,KIBRA,1,2107,2030,4137
32222,NAIROBI,KIBRA,2,2011,2023,4034
32223,NAIROBI,KIBRA,3,1979,1995,3974
32224,NAIROBI,KIBRA,4,1812,1897,3709
32225,NAIROBI,KIBRA,0 - 4,10072,10079,20151
32226,NAIROBI,KIBRA,5,1791,1801,3592
32227,NAIROBI,KIBRA,6,1860,1858,3718
32228,NAIROBI,KIBRA,7,1885,1836,3721
32229,NAIROBI,KIBRA,8,1785,1876,3661
32230,NAIROBI,KIBRA,9,1861,1944,3805
32231,NAIROBI,KIBRA,5-9,9182,9315,18497
32232,NAIROBI,KIBRA,10,1903,1996,3899
32233,NAIROBI,KIBRA,11,1751,1865,3616
32234,NAIROBI,KIBRA,12,1850,2065,3915
32235,NAIROBI,KIBRA,13,1911,2071,3982
32236,NAIROBI,KIBRA,14,1781,1784,3565
32237,NAIROBI,KIBRA,10 -14,9196,9781,18977
32238,NAIROBI,KIBRA,15,1630,1733,3363
32239,NAIROBI,KIBRA,16,1525,1754,3279
32240,NAIROBI,KIBRA,17,1674,1883,3557
32241,NAIROBI,KIBRA,18,1457,1668,3125
32242,NAIROBI,KIBRA,19,1752,2088,3840
32243,NAIROBI,KIBRA,15-19,8038,9126,17164
32244,NAIROBI,KIBRA,20,1890,2264,4154
32245,NAIROBI,KIBRA,21,1994,2240,4234
32246,NAIROBI,KIBRA,22,2223,2399,4622
32247,NAIROBI,KIBRA,23,2373,2639,5012
32248,NAIROBI,KIBRA,24,2336,2403,4739
32249,NAIROBI,KIBRA,20-24,10816,11945,22761
32250,NAIROBI,KIBRA,25,2448,2347,4795
32251,NAIROBI,KIBRA,26,2017,2176,4193
32252,NAIROBI,KIBRA,27,2049,2270,4319
32253,NAIROBI,KIBRA,28,1820,1797,3617
32254,NAIROBI,KIBRA,29,1793,1871,3664
32255,NAIROBI,KIBRA,25-29,10127,10461,20588
32256,NAIROBI,KIBRA,30,2289,2488,4777
32257,NAIROBI,KIBRA,31,1468,1544,3012
32258,NAIROBI,KIBRA,32,2000,2118,4118
32259,NAIROBI,KIBRA,33,1577,1589,3166
32260,NAIROBI,KIBRA,34,1488,1658,3146
32261,NAIROBI,KIBRA,30-34,8822,9397,18219
32262,NAIROBI,KIBRA,35,1971,1839,3810
32263,NAIROBI,KIBRA,36,1395,1335,2730
32264,NAIROBI,KIBRA,37,1388,1233,2621
32265,NAIROBI,KIBRA,38,1170,1155,2325
32266,NAIROBI,KIBRA,39,1309,1166,2475
32267,NAIROBI,KIBRA,35-39,7233,6728,13961
32268,NAIROBI,KIBRA,40,1661,1413,3074
32269,NAIROBI,KIBRA,41,1358,1137,2495
32270,NAIROBI,KIBRA,42,1232,1093,2325
32271,NAIROBI,KIBRA,43,1183,895,2078
32272,NAIROBI,KIBRA,44,866,739,1605
32273,NAIROBI,KIBRA,40-44,6300,5277,11577
32274,NAIROBI,KIBRA,45,1389,970,2359
32275,NAIROBI,KIBRA,46,1035,732,1767
32276,NAIROBI,KIBRA,47,988,701,1689
32277,NAIROBI,KIBRA,48,756,569,1325
32278,NAIROBI,KIBRA,49,793,532,1325
32279,NAIROBI,KIBRA,45-49,4961,3504,8465
32280,NAIROBI,KIBRA,50,1052,695,1747
32281,NAIROBI,KIBRA,51,736,462,1198
32282,NAIROBI,KIBRA,52,664,408,1072
32283,NAIROBI,KIBRA,53,547,336,883
32284,NAIROBI,KIBRA,54,660,382,1042
32285,NAIROBI,KIBRA,50-54,3659,2283,5942
32286,NAIROBI,KIBRA,55,673,330,1003
32287,NAIROBI,KIBRA,56,592,399,991
32288,NAIROBI,KIBRA,57,570,363,933
32289,NAIROBI,KIBRA,58,415,245,660
32290,NAIROBI,KIBRA,59,429,254,683
32291,NAIROBI,KIBRA,55-59,2679,1591,4270
32292,NAIROBI,KIBRA,60,533,298,831
32293,NAIROBI,KIBRA,61,341,190,531
32294,NAIROBI,KIBRA,62,307,155,462
32295,NAIROBI,KIBRA,63,250,159,409
32296,NAIROBI,KIBRA,64,177,128,305
32297,NAIROBI,KIBRA,60-64,1608,930,2538
32298,NAIROBI,KIBRA,65,247,137,384
32299,NAIROBI,KIBRA,66,129,113,242
32300,NAIROBI,KIBRA,67,200,130,330
32301,NAIROBI,KIBRA,68,107,73,180
32302,NAIROBI,KIBRA,69,133,92,225
32303,NAIROBI,KIBRA,65-69,816,545,1361
32304,NAIROBI,KIBRA,70,133,110,243
32305,NAIROBI,KIBRA,71,82,60,142
32306,NAIROBI,KIBRA,72,75,48,123
32307,NAIROBI,KIBRA,73,62,60,122
32308,NAIROBI,KIBRA,74,52,51,103
32309,NAIROBI,KIBRA,70-74,404,329,733
32310,NAIROBI,KIBRA,75,52,44,96
32311,NAIROBI,KIBRA,76,42,33,75
32312,NAIROBI,KIBRA,77,24,30,54
32313,NAIROBI,KIBRA,78,21,12,33
32314,NAIROBI,KIBRA,79,21,23,44
32315,NAIROBI,KIBRA,75-79,160,142,302
32316,NAIROBI,KIBRA,80,22,20,42
32317,NAIROBI,KIBRA,81,14,15,29
32318,NAIROBI,KIBRA,82,18,12,30
32319,NAIROBI,KIBRA,83,18,3,21
32320,NAIROBI,KIBRA,84,9,14,23
32321,NAIROBI,KIBRA,80-84,81,64,145
32322,NAIROBI,KIBRA,85,7,5,12
32323,NAIROBI,KIBRA,86,7,11,18
32324,NAIROBI,KIBRA,87,3,4,7
32325,NAIROBI,KIBRA,88,4,3,7
32326,NAIROBI,KIBRA,89,6,9,15
32327,NAIROBI,KIBRA,85-89,27,32,59
32328,NAIROBI,KIBRA,90,3,3,6
32329,NAIROBI,KIBRA,91,1,4,5
32330,NAIROBI,KIBRA,92,2,3,5
32331,NAIROBI,KIBRA,93,2,5,7
32332,NAIROBI,KIBRA,94,4,1,5
32333,NAIROBI,KIBRA,90-94,12,16,28
32334,NAIROBI,KIBRA,95,1,3,4
32335,NAIROBI,KIBRA,96,2,-,2
32336,NAIROBI,KIBRA,97,-,-,-
32337,NAIROBI,KIBRA,98,-,1,1
32338,NAIROBI,KIBRA,99,-,5,5
32339,NAIROBI,KIBRA,95-99,3,9,12
32340,NAIROBI,KIBRA,100+,-,11,11
32341,NAIROBI,KIBRA,Not Stated,3,4,7
32342,NAIROBI,LANG'ATA,Total,96698,100774,197472
32343,NAIROBI,LANG'ATA,0,1828,1707,3535
32344,NAIROBI,LANG'ATA,1,1857,1827,3684
32345,NAIROBI,LANG'ATA,2,1822,1777,3599
32346,NAIROBI,LANG'ATA,3,1796,1847,3643
32347,NAIROBI,LANG'ATA,4,1759,1695,3454
32348,NAIROBI,LANG'ATA,0 - 4,9062,8853,17915
32349,NAIROBI,LANG'ATA,5,1765,1743,3508
32350,NAIROBI,LANG'ATA,6,1735,1667,3402
32351,NAIROBI,LANG'ATA,7,1769,1687,3456
32352,NAIROBI,LANG'ATA,8,1705,1652,3357
32353,NAIROBI,LANG'ATA,9,1728,1729,3457
32354,NAIROBI,LANG'ATA,5-9,8702,8478,17180
32355,NAIROBI,LANG'ATA,10,1659,1650,3309
32356,NAIROBI,LANG'ATA,11,1552,1617,3169
32357,NAIROBI,LANG'ATA,12,1608,1632,3240
32358,NAIROBI,LANG'ATA,13,1528,1701,3229
32359,NAIROBI,LANG'ATA,14,1558,1618,3176
32360,NAIROBI,LANG'ATA,10 -14,7905,8218,16123
32361,NAIROBI,LANG'ATA,15,1391,1573,2964
32362,NAIROBI,LANG'ATA,16,1482,1720,3202
32363,NAIROBI,LANG'ATA,17,1512,1683,3195
32364,NAIROBI,LANG'ATA,18,1470,1836,3306
32365,NAIROBI,LANG'ATA,19,1792,2303,4095
32366,NAIROBI,LANG'ATA,15-19,7647,9115,16762
32367,NAIROBI,LANG'ATA,20,1986,2541,4527
32368,NAIROBI,LANG'ATA,21,2121,2652,4773
32369,NAIROBI,LANG'ATA,22,2157,2700,4857
32370,NAIROBI,LANG'ATA,23,2447,2878,5325
32371,NAIROBI,LANG'ATA,24,2492,2681,5173
32372,NAIROBI,LANG'ATA,20-24,11203,13452,24655
32373,NAIROBI,LANG'ATA,25,2452,2680,5132
32374,NAIROBI,LANG'ATA,26,2095,2440,4535
32375,NAIROBI,LANG'ATA,27,2122,2318,4440
32376,NAIROBI,LANG'ATA,28,1943,2077,4020
32377,NAIROBI,LANG'ATA,29,1940,2226,4166
32378,NAIROBI,LANG'ATA,25-29,10552,11741,22293
32379,NAIROBI,LANG'ATA,30,2205,2604,4809
32380,NAIROBI,LANG'ATA,31,1676,1867,3543
32381,NAIROBI,LANG'ATA,32,2021,2295,4316
32382,NAIROBI,LANG'ATA,33,1740,1890,3630
32383,NAIROBI,LANG'ATA,34,1642,1790,3432
32384,NAIROBI,LANG'ATA,30-34,9284,10446,19730
32385,NAIROBI,LANG'ATA,35,1906,2089,3995
32386,NAIROBI,LANG'ATA,36,1508,1594,3102
32387,NAIROBI,LANG'ATA,37,1515,1534,3049
32388,NAIROBI,LANG'ATA,38,1338,1502,2840
32389,NAIROBI,LANG'ATA,39,1384,1517,2901
32390,NAIROBI,LANG'ATA,35-39,7651,8236,15887
32391,NAIROBI,LANG'ATA,40,1573,1750,3323
32392,NAIROBI,LANG'ATA,41,1413,1310,2723
32393,NAIROBI,LANG'ATA,42,1389,1379,2768
32394,NAIROBI,LANG'ATA,43,1189,1248,2437
32395,NAIROBI,LANG'ATA,44,1051,1028,2079
32396,NAIROBI,LANG'ATA,40-44,6615,6715,13330
32397,NAIROBI,LANG'ATA,45,1449,1323,2772
32398,NAIROBI,LANG'ATA,46,1073,976,2049
32399,NAIROBI,LANG'ATA,47,1151,997,2148
32400,NAIROBI,LANG'ATA,48,925,789,1714
32401,NAIROBI,LANG'ATA,49,1030,826,1856
32402,NAIROBI,LANG'ATA,45-49,5628,4911,10539
32403,NAIROBI,LANG'ATA,50,1171,967,2138
32404,NAIROBI,LANG'ATA,51,777,656,1433
32405,NAIROBI,LANG'ATA,52,895,658,1553
32406,NAIROBI,LANG'ATA,53,689,595,1284
32407,NAIROBI,LANG'ATA,54,709,602,1311
32408,NAIROBI,LANG'ATA,50-54,4241,3478,7719
32409,NAIROBI,LANG'ATA,55,723,520,1243
32410,NAIROBI,LANG'ATA,56,722,582,1304
32411,NAIROBI,LANG'ATA,57,678,509,1187
32412,NAIROBI,LANG'ATA,58,593,445,1038
32413,NAIROBI,LANG'ATA,59,614,476,1090
32414,NAIROBI,LANG'ATA,55-59,3330,2532,5862
32415,NAIROBI,LANG'ATA,60,539,536,1075
32416,NAIROBI,LANG'ATA,61,383,339,722
32417,NAIROBI,LANG'ATA,62,402,362,764
32418,NAIROBI,LANG'ATA,63,323,342,665
32419,NAIROBI,LANG'ATA,64,277,249,526
32420,NAIROBI,LANG'ATA,60-64,1924,1828,3752
32421,NAIROBI,LANG'ATA,65,327,281,608
32422,NAIROBI,LANG'ATA,66,258,230,488
32423,NAIROBI,LANG'ATA,67,324,234,558
32424,NAIROBI,LANG'ATA,68,196,185,381
32425,NAIROBI,LANG'ATA,69,230,222,452
32426,NAIROBI,LANG'ATA,65-69,1335,1152,2487
32427,NAIROBI,LANG'ATA,70,240,247,487
32428,NAIROBI,LANG'ATA,71,189,173,362
32429,NAIROBI,LANG'ATA,72,164,137,301
32430,NAIROBI,LANG'ATA,73,133,125,258
32431,NAIROBI,LANG'ATA,74,123,113,236
32432,NAIROBI,LANG'ATA,70-74,849,795,1644
32433,NAIROBI,LANG'ATA,75,108,112,220
32434,NAIROBI,LANG'ATA,76,99,86,185
32435,NAIROBI,LANG'ATA,77,76,97,173
32436,NAIROBI,LANG'ATA,78,63,63,126
32437,NAIROBI,LANG'ATA,79,71,49,120
32438,NAIROBI,LANG'ATA,75-79,417,407,824
32439,NAIROBI,LANG'ATA,80,62,84,146
32440,NAIROBI,LANG'ATA,81,37,42,79
32441,NAIROBI,LANG'ATA,82,47,51,98
32442,NAIROBI,LANG'ATA,83,43,37,80
32443,NAIROBI,LANG'ATA,84,35,33,68
32444,NAIROBI,LANG'ATA,80-84,224,247,471
32445,NAIROBI,LANG'ATA,85,23,23,46
32446,NAIROBI,LANG'ATA,86,17,19,36
32447,NAIROBI,LANG'ATA,87,12,19,31
32448,NAIROBI,LANG'ATA,88,12,12,24
32449,NAIROBI,LANG'ATA,89,8,18,26
32450,NAIROBI,LANG'ATA,85-89,72,91,163
32451,NAIROBI,LANG'ATA,90,14,15,29
32452,NAIROBI,LANG'ATA,91,9,13,22
32453,NAIROBI,LANG'ATA,92,4,7,11
32454,NAIROBI,LANG'ATA,93,4,5,9
32455,NAIROBI,LANG'ATA,94,4,4,8
32456,NAIROBI,LANG'ATA,90-94,35,44,79
32457,NAIROBI,LANG'ATA,95,3,2,5
32458,NAIROBI,LANG'ATA,96,5,7,12
32459,NAIROBI,LANG'ATA,97,3,3,6
32460,NAIROBI,LANG'ATA,98,1,3,4
32461,NAIROBI,LANG'ATA,99,2,4,6
32462,NAIROBI,LANG'ATA,95-99,14,19,33
32463,NAIROBI,LANG'ATA,100+,3,15,18
32464,NAIROBI,LANG'ATA,Not Stated,5,1,6
32465,NAIROBI,MAKADARA,Total,96369,93157,189526
32466,NAIROBI,MAKADARA,0,2255,2044,4299
32467,NAIROBI,MAKADARA,1,2203,2019,4222
32468,NAIROBI,MAKADARA,2,2078,1932,4010
32469,NAIROBI,MAKADARA,3,2010,1986,3996
32470,NAIROBI,MAKADARA,4,1869,1852,3721
32471,NAIROBI,MAKADARA,0 - 4,10415,9833,20248
32472,NAIROBI,MAKADARA,5,1717,1747,3464
32473,NAIROBI,MAKADARA,6,1724,1680,3404
32474,NAIROBI,MAKADARA,7,1612,1753,3365
32475,NAIROBI,MAKADARA,8,1617,1641,3258
32476,NAIROBI,MAKADARA,9,1644,1722,3366
32477,NAIROBI,MAKADARA,5-9,8314,8543,16857
32478,NAIROBI,MAKADARA,10,1656,1633,3289
32479,NAIROBI,MAKADARA,11,1461,1485,2946
32480,NAIROBI,MAKADARA,12,1572,1600,3172
32481,NAIROBI,MAKADARA,13,1565,1595,3160
32482,NAIROBI,MAKADARA,14,1435,1464,2899
32483,NAIROBI,MAKADARA,10 -14,7689,7777,15466
32484,NAIROBI,MAKADARA,15,1262,1440,2702
32485,NAIROBI,MAKADARA,16,1281,1465,2746
32486,NAIROBI,MAKADARA,17,1330,1529,2859
32487,NAIROBI,MAKADARA,18,1222,1547,2769
32488,NAIROBI,MAKADARA,19,1609,2033,3642
32489,NAIROBI,MAKADARA,15-19,6704,8014,14718
32490,NAIROBI,MAKADARA,20,1843,2435,4278
32491,NAIROBI,MAKADARA,21,2077,2546,4623
32492,NAIROBI,MAKADARA,22,2416,2635,5051
32493,NAIROBI,MAKADARA,23,2762,3023,5785
32494,NAIROBI,MAKADARA,24,2716,2767,5483
32495,NAIROBI,MAKADARA,20-24,11814,13406,25220
32496,NAIROBI,MAKADARA,25,2876,2983,5859
32497,NAIROBI,MAKADARA,26,2512,2601,5113
32498,NAIROBI,MAKADARA,27,2414,2418,4832
32499,NAIROBI,MAKADARA,28,2103,2168,4271
32500,NAIROBI,MAKADARA,29,2315,2273,4588
32501,NAIROBI,MAKADARA,25-29,12220,12443,24663
32502,NAIROBI,MAKADARA,30,2688,2625,5313
32503,NAIROBI,MAKADARA,31,1791,1779,3570
32504,NAIROBI,MAKADARA,32,2356,2319,4675
32505,NAIROBI,MAKADARA,33,1814,1839,3653
32506,NAIROBI,MAKADARA,34,1746,1697,3443
32507,NAIROBI,MAKADARA,30-34,10395,10259,20654
32508,NAIROBI,MAKADARA,35,2171,1910,4081
32509,NAIROBI,MAKADARA,36,1595,1486,3081
32510,NAIROBI,MAKADARA,37,1586,1392,2978
32511,NAIROBI,MAKADARA,38,1354,1259,2613
32512,NAIROBI,MAKADARA,39,1440,1245,2685
32513,NAIROBI,MAKADARA,35-39,8146,7292,15438
32514,NAIROBI,MAKADARA,40,1735,1395,3130
32515,NAIROBI,MAKADARA,41,1473,1146,2619
32516,NAIROBI,MAKADARA,42,1367,1097,2464
32517,NAIROBI,MAKADARA,43,1168,921,2089
32518,NAIROBI,MAKADARA,44,998,814,1812
32519,NAIROBI,MAKADARA,40-44,6741,5373,12114
32520,NAIROBI,MAKADARA,45,1443,1015,2458
32521,NAIROBI,MAKADARA,46,988,762,1750
32522,NAIROBI,MAKADARA,47,1052,699,1751
32523,NAIROBI,MAKADARA,48,802,594,1396
32524,NAIROBI,MAKADARA,49,849,637,1486
32525,NAIROBI,MAKADARA,45-49,5134,3707,8841
32526,NAIROBI,MAKADARA,50,971,715,1686
32527,NAIROBI,MAKADARA,51,649,477,1126
32528,NAIROBI,MAKADARA,52,712,489,1201
32529,NAIROBI,MAKADARA,53,510,356,866
32530,NAIROBI,MAKADARA,54,587,376,963
32531,NAIROBI,MAKADARA,50-54,3429,2413,5842
32532,NAIROBI,MAKADARA,55,562,387,949
32533,NAIROBI,MAKADARA,56,521,394,915
32534,NAIROBI,MAKADARA,57,510,340,850
32535,NAIROBI,MAKADARA,58,396,271,667
32536,NAIROBI,MAKADARA,59,434,249,683
32537,NAIROBI,MAKADARA,55-59,2423,1641,4064
32538,NAIROBI,MAKADARA,60,425,306,731
32539,NAIROBI,MAKADARA,61,255,214,469
32540,NAIROBI,MAKADARA,62,229,169,398
32541,NAIROBI,MAKADARA,63,196,149,345
32542,NAIROBI,MAKADARA,64,161,117,278
32543,NAIROBI,MAKADARA,60-64,1266,955,2221
32544,NAIROBI,MAKADARA,65,206,177,383
32545,NAIROBI,MAKADARA,66,148,112,260
32546,NAIROBI,MAKADARA,67,214,167,381
32547,NAIROBI,MAKADARA,68,112,94,206
32548,NAIROBI,MAKADARA,69,127,123,250
32549,NAIROBI,MAKADARA,65-69,807,673,1480
32550,NAIROBI,MAKADARA,70,177,143,320
32551,NAIROBI,MAKADARA,71,118,76,194
32552,NAIROBI,MAKADARA,72,105,72,177
32553,NAIROBI,MAKADARA,73,76,60,136
32554,NAIROBI,MAKADARA,74,58,64,122
32555,NAIROBI,MAKADARA,70-74,534,415,949
32556,NAIROBI,MAKADARA,75,59,44,103
32557,NAIROBI,MAKADARA,76,43,49,92
32558,NAIROBI,MAKADARA,77,38,35,73
32559,NAIROBI,MAKADARA,78,25,28,53
32560,NAIROBI,MAKADARA,79,29,39,68
32561,NAIROBI,MAKADARA,75-79,194,195,389
32562,NAIROBI,MAKADARA,80,33,46,79
32563,NAIROBI,MAKADARA,81,13,14,27
32564,NAIROBI,MAKADARA,82,15,22,37
32565,NAIROBI,MAKADARA,83,14,15,29
32566,NAIROBI,MAKADARA,84,15,11,26
32567,NAIROBI,MAKADARA,80-84,90,108,198
32568,NAIROBI,MAKADARA,85,8,18,26
32569,NAIROBI,MAKADARA,86,9,13,22
32570,NAIROBI,MAKADARA,87,8,10,18
32571,NAIROBI,MAKADARA,88,5,5,10
32572,NAIROBI,MAKADARA,89,5,14,19
32573,NAIROBI,MAKADARA,85-89,35,60,95
32574,NAIROBI,MAKADARA,90,6,9,15
32575,NAIROBI,MAKADARA,91,2,5,7
32576,NAIROBI,MAKADARA,92,1,6,7
32577,NAIROBI,MAKADARA,93,1,4,5
32578,NAIROBI,MAKADARA,94,-,4,4
32579,NAIROBI,MAKADARA,90-94,10,28,38
32580,NAIROBI,MAKADARA,95,2,4,6
32581,NAIROBI,MAKADARA,96,2,3,5
32582,NAIROBI,MAKADARA,97,-,2,2
32583,NAIROBI,MAKADARA,98,1,1,2
32584,NAIROBI,MAKADARA,99,-,3,3
32585,NAIROBI,MAKADARA,95-99,5,13,18
32586,NAIROBI,MAKADARA,100+,2,8,10
32587,NAIROBI,MAKADARA,Not Stated,2,1,3
32588,NAIROBI,MATHARE,Total,106522,100028,206550
32589,NAIROBI,MATHARE,0,2621,2810,5431
32590,NAIROBI,MATHARE,1,2747,2703,5450
32591,NAIROBI,MATHARE,2,2551,2451,5002
32592,NAIROBI,MATHARE,3,2444,2522,4966
32593,NAIROBI,MATHARE,4,2233,2275,4508
32594,NAIROBI,MATHARE,0 - 4,12596,12761,25357
32595,NAIROBI,MATHARE,5,2097,2152,4249
32596,NAIROBI,MATHARE,6,2102,2191,4293
32597,NAIROBI,MATHARE,7,2076,2094,4170
32598,NAIROBI,MATHARE,8,2008,1948,3956
32599,NAIROBI,MATHARE,9,2104,2097,4201
32600,NAIROBI,MATHARE,5-9,10387,10482,20869
32601,NAIROBI,MATHARE,10,1905,2002,3907
32602,NAIROBI,MATHARE,11,1649,1836,3485
32603,NAIROBI,MATHARE,12,1981,1988,3969
32604,NAIROBI,MATHARE,13,1760,1965,3725
32605,NAIROBI,MATHARE,14,1605,1807,3412
32606,NAIROBI,MATHARE,10 -14,8900,9598,18498
32607,NAIROBI,MATHARE,15,1538,1684,3222
32608,NAIROBI,MATHARE,16,1496,1595,3091
32609,NAIROBI,MATHARE,17,1644,1847,3491
32610,NAIROBI,MATHARE,18,1514,1799,3313
32611,NAIROBI,MATHARE,19,1910,2187,4097
32612,NAIROBI,MATHARE,15-19,8102,9112,17214
32613,NAIROBI,MATHARE,20,2200,2814,5014
32614,NAIROBI,MATHARE,21,2539,2668,5207
32615,NAIROBI,MATHARE,22,2696,2991,5687
32616,NAIROBI,MATHARE,23,3062,3271,6333
32617,NAIROBI,MATHARE,24,3085,3043,6128
32618,NAIROBI,MATHARE,20-24,13582,14787,28369
32619,NAIROBI,MATHARE,25,3289,3135,6424
32620,NAIROBI,MATHARE,26,2786,2693,5479
32621,NAIROBI,MATHARE,27,2771,2592,5363
32622,NAIROBI,MATHARE,28,2413,2232,4645
32623,NAIROBI,MATHARE,29,2522,2310,4832
32624,NAIROBI,MATHARE,25-29,13781,12962,26743
32625,NAIROBI,MATHARE,30,3079,2945,6024
32626,NAIROBI,MATHARE,31,1978,1807,3785
32627,NAIROBI,MATHARE,32,2693,2480,5173
32628,NAIROBI,MATHARE,33,1968,1857,3825
32629,NAIROBI,MATHARE,34,1859,1665,3524
32630,NAIROBI,MATHARE,30-34,11577,10754,22331
32631,NAIROBI,MATHARE,35,2315,1962,4277
32632,NAIROBI,MATHARE,36,1690,1398,3088
32633,NAIROBI,MATHARE,37,1697,1373,3070
32634,NAIROBI,MATHARE,38,1417,1146,2563
32635,NAIROBI,MATHARE,39,1462,1176,2638
32636,NAIROBI,MATHARE,35-39,8581,7055,15636
32637,NAIROBI,MATHARE,40,1744,1436,3180
32638,NAIROBI,MATHARE,41,1409,1083,2492
32639,NAIROBI,MATHARE,42,1416,1010,2426
32640,NAIROBI,MATHARE,43,1145,833,1978
32641,NAIROBI,MATHARE,44,915,676,1591
32642,NAIROBI,MATHARE,40-44,6629,5038,11667
32643,NAIROBI,MATHARE,45,1379,876,2255
32644,NAIROBI,MATHARE,46,951,618,1569
32645,NAIROBI,MATHARE,47,978,631,1609
32646,NAIROBI,MATHARE,48,744,441,1185
32647,NAIROBI,MATHARE,49,797,456,1253
32648,NAIROBI,MATHARE,45-49,4849,3022,7871
32649,NAIROBI,MATHARE,50,945,587,1532
32650,NAIROBI,MATHARE,51,607,372,979
32651,NAIROBI,MATHARE,52,611,329,940
32652,NAIROBI,MATHARE,53,421,277,698
32653,NAIROBI,MATHARE,54,544,263,807
32654,NAIROBI,MATHARE,50-54,3128,1828,4956
32655,NAIROBI,MATHARE,55,520,267,787
32656,NAIROBI,MATHARE,56,530,281,811
32657,NAIROBI,MATHARE,57,397,241,638
32658,NAIROBI,MATHARE,58,333,160,493
32659,NAIROBI,MATHARE,59,328,211,539
32660,NAIROBI,MATHARE,55-59,2108,1160,3268
32661,NAIROBI,MATHARE,60,362,241,603
32662,NAIROBI,MATHARE,61,261,128,389
32663,NAIROBI,MATHARE,62,197,120,317
32664,NAIROBI,MATHARE,63,183,99,282
32665,NAIROBI,MATHARE,64,141,68,209
32666,NAIROBI,MATHARE,60-64,1144,656,1800
32667,NAIROBI,MATHARE,65,192,120,312
32668,NAIROBI,MATHARE,66,129,58,187
32669,NAIROBI,MATHARE,67,183,101,284
32670,NAIROBI,MATHARE,68,82,43,125
32671,NAIROBI,MATHARE,69,89,68,157
32672,NAIROBI,MATHARE,65-69,675,390,1065
32673,NAIROBI,MATHARE,70,120,93,213
32674,NAIROBI,MATHARE,71,66,44,110
32675,NAIROBI,MATHARE,72,61,27,88
32676,NAIROBI,MATHARE,73,48,20,68
32677,NAIROBI,MATHARE,74,28,22,50
32678,NAIROBI,MATHARE,70-74,323,206,529
32679,NAIROBI,MATHARE,75,22,25,47
32680,NAIROBI,MATHARE,76,26,20,46
32681,NAIROBI,MATHARE,77,17,16,33
32682,NAIROBI,MATHARE,78,14,12,26
32683,NAIROBI,MATHARE,79,14,18,32
32684,NAIROBI,MATHARE,75-79,93,91,184
32685,NAIROBI,MATHARE,80,20,33,53
32686,NAIROBI,MATHARE,81,6,11,17
32687,NAIROBI,MATHARE,82,4,4,8
32688,NAIROBI,MATHARE,83,10,5,15
32689,NAIROBI,MATHARE,84,4,12,16
32690,NAIROBI,MATHARE,80-84,44,65,109
32691,NAIROBI,MATHARE,85,5,7,12
32692,NAIROBI,MATHARE,86,4,7,11
32693,NAIROBI,MATHARE,87,4,4,8
32694,NAIROBI,MATHARE,88,1,4,5
32695,NAIROBI,MATHARE,89,3,8,11
32696,NAIROBI,MATHARE,85-89,17,30,47
32697,NAIROBI,MATHARE,90,2,2,4
32698,NAIROBI,MATHARE,91,-,3,3
32699,NAIROBI,MATHARE,92,-,5,5
32700,NAIROBI,MATHARE,93,-,4,4
32701,NAIROBI,MATHARE,94,1,1,2
32702,NAIROBI,MATHARE,90-94,3,15,18
32703,NAIROBI,MATHARE,95,-,2,2
32704,NAIROBI,MATHARE,96,1,5,6
32705,NAIROBI,MATHARE,97,-,2,2
32706,NAIROBI,MATHARE,98,-,-,-
32707,NAIROBI,MATHARE,99,-,2,2
32708,NAIROBI,MATHARE,95-99,1,11,12
32709,NAIROBI,MATHARE,100+,1,3,4
32710,NAIROBI,MATHARE,Not Stated,1,2,3
32711,NAIROBI,NJIRU,Total,307642,318809,626451
32712,NAIROBI,NJIRU,0,8859,8336,17195
32713,NAIROBI,NJIRU,1,8533,8346,16879
32714,NAIROBI,NJIRU,2,8128,7888,16016
32715,NAIROBI,NJIRU,3,8045,7843,15888
32716,NAIROBI,NJIRU,4,7353,7347,14700
32717,NAIROBI,NJIRU,0 - 4,40918,39760,80678
32718,NAIROBI,NJIRU,5,6984,6981,13965
32719,NAIROBI,NJIRU,6,6781,6942,13723
32720,NAIROBI,NJIRU,7,6970,6977,13947
32721,NAIROBI,NJIRU,8,6468,6816,13284
32722,NAIROBI,NJIRU,9,6823,7066,13889
32723,NAIROBI,NJIRU,5-9,34026,34782,68808
32724,NAIROBI,NJIRU,10,6664,6525,13189
32725,NAIROBI,NJIRU,11,5660,5880,11540
32726,NAIROBI,NJIRU,12,6136,6236,12372
32727,NAIROBI,NJIRU,13,5689,6173,11862
32728,NAIROBI,NJIRU,14,5322,5711,11033
32729,NAIROBI,NJIRU,10 -14,29471,30525,59996
32730,NAIROBI,NJIRU,15,4887,5612,10499
32731,NAIROBI,NJIRU,16,4762,5585,10347
32732,NAIROBI,NJIRU,17,5072,5827,10899
32733,NAIROBI,NJIRU,18,4307,5308,9615
32734,NAIROBI,NJIRU,19,5130,6711,11841
32735,NAIROBI,NJIRU,15-19,24158,29043,53201
32736,NAIROBI,NJIRU,20,5312,7493,12805
32737,NAIROBI,NJIRU,21,5766,7829,13595
32738,NAIROBI,NJIRU,22,6086,8239,14325
32739,NAIROBI,NJIRU,23,6952,9303,16255
32740,NAIROBI,NJIRU,24,7039,9092,16131
32741,NAIROBI,NJIRU,20-24,31155,41956,73111
32742,NAIROBI,NJIRU,25,7724,9147,16871
32743,NAIROBI,NJIRU,26,6825,8191,15016
32744,NAIROBI,NJIRU,27,7202,8031,15233
32745,NAIROBI,NJIRU,28,6348,7180,13528
32746,NAIROBI,NJIRU,29,6865,7530,14395
32747,NAIROBI,NJIRU,25-29,34964,40079,75043
32748,NAIROBI,NJIRU,30,8336,9028,17364
32749,NAIROBI,NJIRU,31,5847,5739,11586
32750,NAIROBI,NJIRU,32,7514,7777,15291
32751,NAIROBI,NJIRU,33,5868,5972,11840
32752,NAIROBI,NJIRU,34,5544,5688,11232
32753,NAIROBI,NJIRU,30-34,33109,34204,67313
32754,NAIROBI,NJIRU,35,6571,6334,12905
32755,NAIROBI,NJIRU,36,4791,4742,9533
32756,NAIROBI,NJIRU,37,4793,4464,9257
32757,NAIROBI,NJIRU,38,4352,4189,8541
32758,NAIROBI,NJIRU,39,4335,4021,8356
32759,NAIROBI,NJIRU,35-39,24842,23750,48592
32760,NAIROBI,NJIRU,40,5255,4565,9820
32761,NAIROBI,NJIRU,41,4053,3475,7528
32762,NAIROBI,NJIRU,42,3971,3315,7286
32763,NAIROBI,NJIRU,43,3419,2900,6319
32764,NAIROBI,NJIRU,44,2689,2479,5168
32765,NAIROBI,NJIRU,40-44,19387,16734,36121
32766,NAIROBI,NJIRU,45,3940,3021,6961
32767,NAIROBI,NJIRU,46,2723,2311,5034
32768,NAIROBI,NJIRU,47,2887,2221,5108
32769,NAIROBI,NJIRU,48,2137,1725,3862
32770,NAIROBI,NJIRU,49,2390,1735,4125
32771,NAIROBI,NJIRU,45-49,14077,11013,25090
32772,NAIROBI,NJIRU,50,2587,2056,4643
32773,NAIROBI,NJIRU,51,1827,1289,3116
32774,NAIROBI,NJIRU,52,1992,1364,3356
32775,NAIROBI,NJIRU,53,1330,1010,2340
32776,NAIROBI,NJIRU,54,1595,1165,2760
32777,NAIROBI,NJIRU,50-54,9331,6884,16215
32778,NAIROBI,NJIRU,55,1472,1003,2475
32779,NAIROBI,NJIRU,56,1409,1061,2470
32780,NAIROBI,NJIRU,57,1177,923,2100
32781,NAIROBI,NJIRU,58,920,713,1633
32782,NAIROBI,NJIRU,59,957,712,1669
32783,NAIROBI,NJIRU,55-59,5935,4412,10347
32784,NAIROBI,NJIRU,60,975,779,1754
32785,NAIROBI,NJIRU,61,706,548,1254
32786,NAIROBI,NJIRU,62,614,395,1009
32787,NAIROBI,NJIRU,63,499,374,873
32788,NAIROBI,NJIRU,64,368,264,632
32789,NAIROBI,NJIRU,60-64,3162,2360,5522
32790,NAIROBI,NJIRU,65,461,373,834
32791,NAIROBI,NJIRU,66,298,242,540
32792,NAIROBI,NJIRU,67,412,365,777
32793,NAIROBI,NJIRU,68,205,168,373
32794,NAIROBI,NJIRU,69,277,244,521
32795,NAIROBI,NJIRU,65-69,1653,1392,3045
32796,NAIROBI,NJIRU,70,284,312,596
32797,NAIROBI,NJIRU,71,186,200,386
32798,NAIROBI,NJIRU,72,188,141,329
32799,NAIROBI,NJIRU,73,116,130,246
32800,NAIROBI,NJIRU,74,102,114,216
32801,NAIROBI,NJIRU,70-74,876,897,1773
32802,NAIROBI,NJIRU,75,76,103,179
32803,NAIROBI,NJIRU,76,92,115,207
32804,NAIROBI,NJIRU,77,67,76,143
32805,NAIROBI,NJIRU,78,42,40,82
32806,NAIROBI,NJIRU,79,45,70,115
32807,NAIROBI,NJIRU,75-79,322,404,726
32808,NAIROBI,NJIRU,80,41,98,139
32809,NAIROBI,NJIRU,81,18,48,66
32810,NAIROBI,NJIRU,82,33,39,72
32811,NAIROBI,NJIRU,83,24,51,75
32812,NAIROBI,NJIRU,84,18,55,73
32813,NAIROBI,NJIRU,80-84,134,291,425
32814,NAIROBI,NJIRU,85,19,26,45
32815,NAIROBI,NJIRU,86,17,37,54
32816,NAIROBI,NJIRU,87,14,27,41
32817,NAIROBI,NJIRU,88,11,13,24
32818,NAIROBI,NJIRU,89,11,48,59
32819,NAIROBI,NJIRU,85-89,72,151,223
32820,NAIROBI,NJIRU,90,4,28,32
32821,NAIROBI,NJIRU,91,7,23,30
32822,NAIROBI,NJIRU,92,3,13,16
32823,NAIROBI,NJIRU,93,5,10,15
32824,NAIROBI,NJIRU,94,4,8,12
32825,NAIROBI,NJIRU,90-94,23,82,105
32826,NAIROBI,NJIRU,95,6,13,19
32827,NAIROBI,NJIRU,96,3,10,13
32828,NAIROBI,NJIRU,97,2,9,11
32829,NAIROBI,NJIRU,98,2,7,9
32830,NAIROBI,NJIRU,99,2,12,14
32831,NAIROBI,NJIRU,95-99,15,51,66
32832,NAIROBI,NJIRU,100+,1,27,28
32833,NAIROBI,NJIRU,Not Stated,11,12,23
32834,NAIROBI,STAREHE,Total,109173,101238,210411
32835,NAIROBI,STAREHE,0,2213,2128,4341
32836,NAIROBI,STAREHE,1,2174,2105,4279
32837,NAIROBI,STAREHE,2,2077,2068,4145
32838,NAIROBI,STAREHE,3,2016,1940,3956
32839,NAIROBI,STAREHE,4,1787,1794,3581
32840,NAIROBI,STAREHE,0 - 4,10267,10035,20302
32841,NAIROBI,STAREHE,5,1857,1750,3607
32842,NAIROBI,STAREHE,6,1724,1757,3481
32843,NAIROBI,STAREHE,7,1707,1657,3364
32844,NAIROBI,STAREHE,8,1637,1620,3257
32845,NAIROBI,STAREHE,9,1666,1804,3470
32846,NAIROBI,STAREHE,5-9,8591,8588,17179
32847,NAIROBI,STAREHE,10,1710,1661,3371
32848,NAIROBI,STAREHE,11,1488,1588,3076
32849,NAIROBI,STAREHE,12,1658,1682,3340
32850,NAIROBI,STAREHE,13,1611,1644,3255
32851,NAIROBI,STAREHE,14,1535,1524,3059
32852,NAIROBI,STAREHE,10 -14,8002,8099,16101
32853,NAIROBI,STAREHE,15,1412,1615,3027
32854,NAIROBI,STAREHE,16,1517,1612,3129
32855,NAIROBI,STAREHE,17,1703,1753,3456
32856,NAIROBI,STAREHE,18,1668,1870,3538
32857,NAIROBI,STAREHE,19,2232,2638,4870
32858,NAIROBI,STAREHE,15-19,8532,9488,18020
32859,NAIROBI,STAREHE,20,2724,3072,5796
32860,NAIROBI,STAREHE,21,3084,3303,6387
32861,NAIROBI,STAREHE,22,3340,3557,6897
32862,NAIROBI,STAREHE,23,3681,3655,7336
32863,NAIROBI,STAREHE,24,3613,3239,6852
32864,NAIROBI,STAREHE,20-24,16442,16826,33268
32865,NAIROBI,STAREHE,25,3670,3314,6984
32866,NAIROBI,STAREHE,26,2952,2779,5731
32867,NAIROBI,STAREHE,27,2960,2668,5628
32868,NAIROBI,STAREHE,28,2534,2453,4987
32869,NAIROBI,STAREHE,29,2582,2270,4852
32870,NAIROBI,STAREHE,25-29,14698,13484,28182
32871,NAIROBI,STAREHE,30,3130,2895,6025
32872,NAIROBI,STAREHE,31,2098,1907,4005
32873,NAIROBI,STAREHE,32,2605,2430,5035
32874,NAIROBI,STAREHE,33,1956,1893,3849
32875,NAIROBI,STAREHE,34,1962,1776,3738
32876,NAIROBI,STAREHE,30-34,11751,10901,22652
32877,NAIROBI,STAREHE,35,2378,2009,4387
32878,NAIROBI,STAREHE,36,1740,1530,3270
32879,NAIROBI,STAREHE,37,1643,1400,3043
32880,NAIROBI,STAREHE,38,1508,1281,2789
32881,NAIROBI,STAREHE,39,1517,1223,2740
32882,NAIROBI,STAREHE,35-39,8786,7443,16229
32883,NAIROBI,STAREHE,40,1913,1376,3289
32884,NAIROBI,STAREHE,41,1480,1086,2566
32885,NAIROBI,STAREHE,42,1469,1094,2563
32886,NAIROBI,STAREHE,43,1157,936,2093
32887,NAIROBI,STAREHE,44,953,793,1746
32888,NAIROBI,STAREHE,40-44,6972,5285,12257
32889,NAIROBI,STAREHE,45,1560,1056,2616
32890,NAIROBI,STAREHE,46,983,745,1728
32891,NAIROBI,STAREHE,47,1000,683,1683
32892,NAIROBI,STAREHE,48,865,570,1435
32893,NAIROBI,STAREHE,49,907,609,1516
32894,NAIROBI,STAREHE,45-49,5315,3663,8978
32895,NAIROBI,STAREHE,50,1044,786,1830
32896,NAIROBI,STAREHE,51,739,485,1224
32897,NAIROBI,STAREHE,52,726,497,1223
32898,NAIROBI,STAREHE,53,549,419,968
32899,NAIROBI,STAREHE,54,677,423,1100
32900,NAIROBI,STAREHE,50-54,3735,2610,6345
32901,NAIROBI,STAREHE,55,612,418,1030
32902,NAIROBI,STAREHE,56,594,421,1015
32903,NAIROBI,STAREHE,57,536,405,941
32904,NAIROBI,STAREHE,58,446,300,746
32905,NAIROBI,STAREHE,59,498,322,820
32906,NAIROBI,STAREHE,55-59,2686,1866,4552
32907,NAIROBI,STAREHE,60,497,399,896
32908,NAIROBI,STAREHE,61,310,209,519
32909,NAIROBI,STAREHE,62,291,208,499
32910,NAIROBI,STAREHE,63,230,187,417
32911,NAIROBI,STAREHE,64,194,171,365
32912,NAIROBI,STAREHE,60-64,1522,1174,2696
32913,NAIROBI,STAREHE,65,287,185,472
32914,NAIROBI,STAREHE,66,154,134,288
32915,NAIROBI,STAREHE,67,223,150,373
32916,NAIROBI,STAREHE,68,135,105,240
32917,NAIROBI,STAREHE,69,139,172,311
32918,NAIROBI,STAREHE,65-69,938,746,1684
32919,NAIROBI,STAREHE,70,161,194,355
32920,NAIROBI,STAREHE,71,98,90,188
32921,NAIROBI,STAREHE,72,98,76,174
32922,NAIROBI,STAREHE,73,81,70,151
32923,NAIROBI,STAREHE,74,74,80,154
32924,NAIROBI,STAREHE,70-74,512,510,1022
32925,NAIROBI,STAREHE,75,59,74,133
32926,NAIROBI,STAREHE,76,61,56,117
32927,NAIROBI,STAREHE,77,48,56,104
32928,NAIROBI,STAREHE,78,27,28,55
32929,NAIROBI,STAREHE,79,33,47,80
32930,NAIROBI,STAREHE,75-79,228,261,489
32931,NAIROBI,STAREHE,80,48,57,105
32932,NAIROBI,STAREHE,81,22,21,43
32933,NAIROBI,STAREHE,82,21,20,41
32934,NAIROBI,STAREHE,83,19,23,42
32935,NAIROBI,STAREHE,84,14,17,31
32936,NAIROBI,STAREHE,80-84,124,138,262
32937,NAIROBI,STAREHE,85,15,20,35
32938,NAIROBI,STAREHE,86,9,11,20
32939,NAIROBI,STAREHE,87,12,18,30
32940,NAIROBI,STAREHE,88,6,10,16
32941,NAIROBI,STAREHE,89,3,8,11
32942,NAIROBI,STAREHE,85-89,45,67,112
32943,NAIROBI,STAREHE,90,7,17,24
32944,NAIROBI,STAREHE,91,2,3,5
32945,NAIROBI,STAREHE,92,1,3,4
32946,NAIROBI,STAREHE,93,1,6,7
32947,NAIROBI,STAREHE,94,-,3,3
32948,NAIROBI,STAREHE,90-94,11,32,43
32949,NAIROBI,STAREHE,95,3,7,10
32950,NAIROBI,STAREHE,96,1,2,3
32951,NAIROBI,STAREHE,97,2,2,4
32952,NAIROBI,STAREHE,98,-,1,1
32953,NAIROBI,STAREHE,99,-,1,1
32954,NAIROBI,STAREHE,95-99,6,13,19
32955,NAIROBI,STAREHE,100+,4,6,10
32956,NAIROBI,STAREHE,Not Stated,6,3,9
32957,NAIROBI,WESTLANDS,Total,153818,155021,308839
32958,NAIROBI,WESTLANDS,0,2978,2940,5918
32959,NAIROBI,WESTLANDS,1,3108,3074,6182
32960,NAIROBI,WESTLANDS,2,2878,2795,5673
32961,NAIROBI,WESTLANDS,3,2798,2853,5651
32962,NAIROBI,WESTLANDS,4,2679,2627,5306
32963,NAIROBI,WESTLANDS,0 - 4,14441,14289,28730
32964,NAIROBI,WESTLANDS,5,2648,2573,5221
32965,NAIROBI,WESTLANDS,6,2517,2641,5158
32966,NAIROBI,WESTLANDS,7,2660,2633,5293
32967,NAIROBI,WESTLANDS,8,2452,2456,4908
32968,NAIROBI,WESTLANDS,9,2608,2627,5235
32969,NAIROBI,WESTLANDS,5-9,12885,12930,25815
32970,NAIROBI,WESTLANDS,10,2452,2507,4959
32971,NAIROBI,WESTLANDS,11,2311,2339,4650
32972,NAIROBI,WESTLANDS,12,2310,2448,4758
32973,NAIROBI,WESTLANDS,13,2362,2506,4868
32974,NAIROBI,WESTLANDS,14,2190,2264,4454
32975,NAIROBI,WESTLANDS,10 -14,11625,12064,23689
32976,NAIROBI,WESTLANDS,15,2104,2132,4236
32977,NAIROBI,WESTLANDS,16,1965,2311,4276
32978,NAIROBI,WESTLANDS,17,2099,2317,4416
32979,NAIROBI,WESTLANDS,18,1887,2187,4074
32980,NAIROBI,WESTLANDS,19,2317,2798,5115
32981,NAIROBI,WESTLANDS,15-19,10372,11745,22117
32982,NAIROBI,WESTLANDS,20,2518,3245,5763
32983,NAIROBI,WESTLANDS,21,2941,3485,6426
32984,NAIROBI,WESTLANDS,22,3144,3600,6744
32985,NAIROBI,WESTLANDS,23,3611,4042,7653
32986,NAIROBI,WESTLANDS,24,3567,3828,7395
32987,NAIROBI,WESTLANDS,20-24,15781,18200,33981
32988,NAIROBI,WESTLANDS,25,3818,3904,7722
32989,NAIROBI,WESTLANDS,26,3442,3650,7092
32990,NAIROBI,WESTLANDS,27,3484,3568,7052
32991,NAIROBI,WESTLANDS,28,3084,3225,6309
32992,NAIROBI,WESTLANDS,29,3348,3464,6812
32993,NAIROBI,WESTLANDS,25-29,17176,17811,34987
32994,NAIROBI,WESTLANDS,30,3726,3924,7650
32995,NAIROBI,WESTLANDS,31,2895,2871,5766
32996,NAIROBI,WESTLANDS,32,3445,3699,7144
32997,NAIROBI,WESTLANDS,33,2825,2980,5805
32998,NAIROBI,WESTLANDS,34,2851,2981,5832
32999,NAIROBI,WESTLANDS,30-34,15742,16455,32197
33000,NAIROBI,WESTLANDS,35,3140,3304,6444
33001,NAIROBI,WESTLANDS,36,2500,2556,5056
33002,NAIROBI,WESTLANDS,37,2467,2421,4888
33003,NAIROBI,WESTLANDS,38,2295,2393,4688
33004,NAIROBI,WESTLANDS,39,2361,2320,4681
33005,NAIROBI,WESTLANDS,35-39,12763,12994,25757
33006,NAIROBI,WESTLANDS,40,2703,2626,5329
33007,NAIROBI,WESTLANDS,41,2241,2124,4365
33008,NAIROBI,WESTLANDS,42,2303,2189,4492
33009,NAIROBI,WESTLANDS,43,2039,2014,4053
33010,NAIROBI,WESTLANDS,44,1858,1747,3605
33011,NAIROBI,WESTLANDS,40-44,11144,10700,21844
33012,NAIROBI,WESTLANDS,45,2347,2122,4469
33013,NAIROBI,WESTLANDS,46,1874,1624,3498
33014,NAIROBI,WESTLANDS,47,1931,1636,3567
33015,NAIROBI,WESTLANDS,48,1544,1361,2905
33016,NAIROBI,WESTLANDS,49,1780,1417,3197
33017,NAIROBI,WESTLANDS,45-49,9476,8160,17636
33018,NAIROBI,WESTLANDS,50,1833,1593,3426
33019,NAIROBI,WESTLANDS,51,1340,1103,2443
33020,NAIROBI,WESTLANDS,52,1408,1191,2599
33021,NAIROBI,WESTLANDS,53,1195,1038,2233
33022,NAIROBI,WESTLANDS,54,1280,1062,2342
33023,NAIROBI,WESTLANDS,50-54,7056,5987,13043
33024,NAIROBI,WESTLANDS,55,1231,998,2229
33025,NAIROBI,WESTLANDS,56,1209,958,2167
33026,NAIROBI,WESTLANDS,57,1141,939,2080
33027,NAIROBI,WESTLANDS,58,980,808,1788
33028,NAIROBI,WESTLANDS,59,1004,785,1789
33029,NAIROBI,WESTLANDS,55-59,5565,4488,10053
33030,NAIROBI,WESTLANDS,60,913,822,1735
33031,NAIROBI,WESTLANDS,61,722,651,1373
33032,NAIROBI,WESTLANDS,62,751,596,1347
33033,NAIROBI,WESTLANDS,63,670,535,1205
33034,NAIROBI,WESTLANDS,64,514,494,1008
33035,NAIROBI,WESTLANDS,60-64,3570,3098,6668
33036,NAIROBI,WESTLANDS,65,653,580,1233
33037,NAIROBI,WESTLANDS,66,474,445,919
33038,NAIROBI,WESTLANDS,67,568,464,1032
33039,NAIROBI,WESTLANDS,68,402,357,759
33040,NAIROBI,WESTLANDS,69,494,367,861
33041,NAIROBI,WESTLANDS,65-69,2591,2213,4804
33042,NAIROBI,WESTLANDS,70,460,436,896
33043,NAIROBI,WESTLANDS,71,359,293,652
33044,NAIROBI,WESTLANDS,72,344,383,727
33045,NAIROBI,WESTLANDS,73,288,285,573
33046,NAIROBI,WESTLANDS,74,287,249,536
33047,NAIROBI,WESTLANDS,70-74,1738,1646,3384
33048,NAIROBI,WESTLANDS,75,235,265,500
33049,NAIROBI,WESTLANDS,76,208,228,436
33050,NAIROBI,WESTLANDS,77,191,191,382
33051,NAIROBI,WESTLANDS,78,150,138,288
33052,NAIROBI,WESTLANDS,79,130,168,298
33053,NAIROBI,WESTLANDS,75-79,914,990,1904
33054,NAIROBI,WESTLANDS,80,159,194,353
33055,NAIROBI,WESTLANDS,81,102,127,229
33056,NAIROBI,WESTLANDS,82,115,142,257
33057,NAIROBI,WESTLANDS,83,106,121,227
33058,NAIROBI,WESTLANDS,84,89,88,177
33059,NAIROBI,WESTLANDS,80-84,571,672,1243
33060,NAIROBI,WESTLANDS,85,87,110,197
33061,NAIROBI,WESTLANDS,86,60,81,141
33062,NAIROBI,WESTLANDS,87,57,81,138
33063,NAIROBI,WESTLANDS,88,42,49,91
33064,NAIROBI,WESTLANDS,89,39,48,87
33065,NAIROBI,WESTLANDS,85-89,285,369,654
33066,NAIROBI,WESTLANDS,90,25,41,66
33067,NAIROBI,WESTLANDS,91,17,23,40
33068,NAIROBI,WESTLANDS,92,21,22,43
33069,NAIROBI,WESTLANDS,93,13,17,30
33070,NAIROBI,WESTLANDS,94,8,21,29
33071,NAIROBI,WESTLANDS,90-94,84,124,208
33072,NAIROBI,WESTLANDS,95,6,19,25
33073,NAIROBI,WESTLANDS,96,6,14,20
33074,NAIROBI,WESTLANDS,97,5,8,13
33075,NAIROBI,WESTLANDS,98,3,8,11
33076,NAIROBI,WESTLANDS,99,9,14,23
33077,NAIROBI,WESTLANDS,95-99,29,63,92
33078,NAIROBI,WESTLANDS,100+,7,16,23
33079,NAIROBI,WESTLANDS,Not Stated,3,7,10
